R 1080 720
NO ./wolftex/greystone.png
SO ./wolftex/redbrick.png
WE ./wolftex/wood.png
EA ./wolftex/wood.png
S ./wolftex/barrel.png
F 25,122,254
C 100,200,160

11111111111111111
10000000000000001
10000000000000001
10000000000000001
10000000000000001
10000000000000001
10000000N00000001
10000000000000001
10000000000000001
10000000000000001
10000000000000001
10000000000000001
11111111111111111