   R 900    480




      NO ./textures/wood.xpm
      EA ./textures/bricks.xpm
      SO ./textures/sample.xpm
  WE ./textures/wood.xpm
      S ./path_to_the_sprite_texture

     F    102, 79, 120
     C    160, 200, 222


        1111111111111111111111111
        10000000001100000000000011
        100110000011100000020000011
        10010000000000000000000011
111111111011000001110000000000001
100000000011000001110111110111111
11110111111111011100000010001
11110111111111011101010010001
01000000110101011100000000001
10002000000000001100000010001
10000000000000001101010010001
1100000111010101111101111000111
1111E111 1110101 101111010001
11111111 1111111 111111111111