   R 20000    1000




      NO ./textures/brick.xpm
      EA ./textures/diertjes.xpm
      SO ./textures/plantdonker.xpm
  WE ./textures/wood.xpm
      S ./sprites/tiger.png

     F    49, 79, 49
     C    101, 133, 161


        1111111111111111111111111
        10000000001100000000000011
        100110000011100000020000011
        10010000000000000000000011
111111111011000001110000000000001
100000000011000001110111110111111
11110111111111011100000010001
11110111111111011101010010001
11000000110101011100000000001
10002000000000001100000010001
100000N0000000001101010010001
1100000111010101111101111000111
11111111 1110101 101111010001
11111111 1111111 111111111111